[{
  "level": 
  [
  [1, 1, 1, 1, 1, 1, 1, 1],
  [1, 1, 0, 0, 1, 1, 1, 1],
  [1, 1, 4, 0, 4, 3, 6, 1],
  [1, 1, 0, 0, 0, 1, 0, 1],
  [1, 1, 1, 3, 3, 0, 0, 1],
  [1, 1, 1, 0, 0, 7, 1, 1],
  [1, 1, 1, 0, 0, 0, 1, 1],
  [1, 1, 1, 1, 1, 1, 1, 1]
  ]
}]
